################################################################################################################################################################################################################################################
################################################################################################################################################################################################################################################
#
#
#
#
#
#
#
#
#
#
#
#
#
#
#
#
#
#
#
#
#
#
#
#
#
#
#
#
#
#
#
#
#
#
#
#
#
#
#
#
#
#
#
#
#
#
#
#
#
#
#
#
#
#
#
#
#
#
#
#
#
#
#
#
#
#
#
###################################################                                                         ####################################################################################################################################
#
#
#
#
#
#
#
#
#
#
#
#
#
#
#
#
#
#
#
#
#
#
#
#
#
#
#
#
#
#
#
#
#
#
#
#
#
#
#
#
#
#
#
#
#
#
#
#
#
#
#
#
#
#
#
#
#
#
#
#
#
#
#
#
#
#
#
#
#
#
#
#
#
#
#                                 
##                                
##                                wwwwwwwwwwwwwwwwwwwwwwwwwwwwwwwwwwwwwwwwwwwwwwwwwwwwwwwwwwwwwwwwwwwwwww##############################################################################
###                               wwwwwwwwwwwwwwwwwwwwwwwwwwwwwwwwwwwwwwwwwwwwwwwwwwwwwwwwwwwwwwwwwwwwwww##############################################################################-----------------------------------------------##########
####------------------------------wwwwwwwwwwwwwwwwwwwwwwwwwwwwwwwwwwww#################################################################################################################                                                        #
####                              wwwwwwwwwwwwwwwwwwwwwwwwwwwwwwwwwwww###################################                                                                                                                                      #
####                              wwwwwwwwwwwwwwwwwwwwwwwwwwwwwwwwwwww###################################                                                                                                                                      #
####                              wwwwwwwwwwwwwwwwwwwwwwwwwwwwwwwwwwww###################################                                                                                                                                      #
####                              wwwwwwwwwwwwwwwwwwwwwwwwwwwwwwwwwwww###################################                                                                                                                                      #
######                            wwwwwwwwwwwwwwwwwwwwwwwwwwwwwwwwwww!###################################                                                                                                                                      #
######                                                                ###################################                                                                                                                                      #
########                                                              ###################################                                                                                                                                      #
########                                                              ###################################                                                                                                                                      #
###########                                                           ###################################                                                                                                                                      #
#############                                                         ###################################                                                                                                                                      #
#############                                                         #################################################################---------------------------------------------------------################################################
#wwwwwwwwwwwwwwwwwwwwwwwwwwwwwwwwwwwwwwwwwwwwwwwwwwwwwwwwwwwwwwwwwwwwww                                                                                                                                                                        #
#wwwwwwwwwwwwwwwwwwwwwwwwwwwwwwwwwwwwwwwwwwwwwwwwwwwwwwwwwwwwwwwwwwwwww                                                                                                                                                                        #
#wwwwwwwwwwwwwwwwwwwwwwwwwwwwwwwwwwwwwwwwwwwwwwwwwwwwwwwwwwwwwwwwwwwwww                                                                                                                                                                        #
#wwwwwwwwwwwwwwwwwwwwwwwwwwwwwwwwwwwwwwwwwwwwwwwwwwwwwwwwwwwwwwwwwwwwww                                                                                                                                                                        #
#wwwwwwwwwwwwwwwwwwwwwwwwwwwwwwwwwwwwwwwwwwwwwwwwwwwwwwwwwwwwwwwwwwwwww                                                                                                                                                                        #
#wwwwwwwwwwwwwwwwwwwwwwwwwwwwwwwwwwwwwwwwwwwwwwwwwwwwwwwwwwwwwwwwwwwwww                                                                                                                                                                        #
#wwwwwwwwwwwwwwwwwwwwwwwwwwwwwwwwwwwwwwwwwwwwwwwwwwwwwwwwwwwwwwwwwwwwww                                                                                                                                                                        #
#wwwwwwwwwwwwwwwwwwwwwwwwwwwwwwwwwwwwwwwwww            wwwwwwwwwwwwwwww                                                                                                                                                                        #
#wwwwwwwwwwwwwwwwwwwwwwwwwwwwwwwwwwwwwwwwww            wwwwwwwwwwwwwwww                                                                                                                                                                        #
###########################################            ####################                                                                                                                                                                    #
#wwwwwwwwwwwwwwwwwwwwwwwwwwwwwwwwwwwwwwwwwwwwwwwwwwwwww####################                                                                                                                                                                    #
#wwwwwwwwwwwwwwwwwwwwwwwwwwwwwwwwwwwwwwwwwwwwwwwwwwwwww####################                                                                                                                                                                    #
#wwwwwwwwwwwwwwwwwwwwwwwwwwwwwwwwwwwwwwwwwwwwwwwwwwwwww####################                                                                                                                                                                    #
#wwwwwwwwwwwwwwwwwwwwwwwwwwwwwwwwwwwwwwwwwwwwwwwwwwwwww####################                        #####                                                                                                                                       #
#wwwwwwwwwwwwwwwwwwwwwwwwwwwwwwwwwwwwwwwwwwwwwwwwwwwwww####################                       #######                                                                                                                                      #
#wwwwwwwwwwwwwwwwwwwwwwwwwwwwwwwwwwwwwwwwwwwwwwwwwwwwww####################                     ###########                                                                                                                                    #
#wwwwwwwwwwwwwwwwwwwwwwwwwwwwwwwwwwwwwwwwwwwwwwwwwwwwww####################wwwwwwwwwwwwwwwwwww###############wwwwwwwwwwwwwwwwwwwwwwwwwwww#########                                      #########wwwwwwwwwwwwwwwwwwwwwwwwwwwww   wwwwwwwwwwwww##
#wwwwwwwwwwwwwwwwwwwwwwwwwwwwwwwwwwwwwwwwwwwwwwwwwwwwww####################wwwwwwwwwwwwwwwwwwwww###########wwwwwwwwwwwwwwwwwwwwwwwwwwww###########                                      ###########wwwwwwwwwwwwwwwwwwwwwwwwwww    wwwwwwwwwwww##
#     wwwwwwwwwwwwwwwwwwwwwwwwwwwwwwwwwwwwwwwwwwwwwwwww####################wwwwwwwwwwwwwwwwwwwwwww#######wwwwwwwwwwwwwwwwwwwwwwwwwwwwww###########                                      ###########wwwwwwwwwwwwwwwwwwwwwwwwwwwwwwwwwwwwwwwww####
#     wwwwwwwwwwwwwwwwwwwwwwwwwwwwwwwwwwwwwwwwwwwwwwwww####################wwwwwwwwwwwwwwwwwwwwwwww#####wwwwwwwwwwwwwwwwwwwwwwwwwwwww#############                                      #############wwwwwwwwwww   wwwwwwwwwwwwwwwwwwwwwwwww####
#          wwwwwwwwwwwwwwwwwwwwwwwwwwwwwwwwwwwwwwwwwwww####################  wwwwwwwwwwwwwwwwwwwwwwwwwwwwwwwwwwwwwwwwwwwwwwwwwwwwwwww#############                                      #############wwwwwwwwwww    wwwwwwwwwww   wwwwwww#######
#          wwwwwwwwwwwwwwwwwwwwwwwwwwwwwwwwwwwwwwwwwwww####################   wwwwwwwwwwwwwwwwwwwwwwwwwwwwwwwwwwwwwwwwwwwwwwwwwwwww###############                                      ###############wwwwwwwwwwwwwwwwwwwwwwww    wwwwww#######
##################################################################################################################################################                                      ########################################################
##################################################################################################################################################                                      ########################################################
##################################################################################################################################################                                      ########################################################
##################################################################################################################################################                                      ########################################################
##################################################################################################################################################                                      ########################################################
##################################################################################################################################################                                      ########################################################
##################################################################################################################################################                                      ########################################################
##################################################################################################################################################                                      ########################################################
##################################################################################################################################################                                      ########################################################
##################################################################################################################################################                                      ########################################################
##################################################################                                ########################                                                                                 #///////////////////////#############
########################################/////////////////////####                                ##########################                                                                                #///////////////////////#############
#/////////////////////##################/////////////////////####                                 ########################                                                                                 #///////////////////////#############
#/////////////////////##################/////////////////////###                                   #####################                                                                                   #///////////////////////#############
#/////////////////////##################/////////////////////###                                      ################                                                                                     #///////////////////////#############
#/////////////////////#                #/////////////////////###                                    ####################                                                                                   #///////////////////////#############
#/////////////////////#                #/////////////////////##                                    ######################                                                                                  #///////////////////////#############
#/////////////////////#                #/////////////////////#                                    ########################                                                                                                               #######
#/////////////////////#                                                                          ##########################                                                                                                                 ####
#                                                                                               ############################                                                                                                                  ##
#                                                                                                ##########################                                                                                                                    #
#                                                                                                 ########################                                                                                                                     #
#                                                                                                  ######################                                                                                                                      #
#                                                                                                   ####################                                                                                                                       #
#                                                                                                    ##################                                                                                                                        #
#                                                                                                     ################                                                                                                                         #
#                                                                                                      ##############                                                                                                                          #
#                                                                                                                                                                                                                                              #
#                                                                                                                                                                                                                                              #
#                                                                                                                                                                                                                                              #
#                                                                                                                                                                                                                                              #
#                                                                                                                                                                                                                                              #
#                                                                                                                                                                                                                                              #
#                                                                                                                                                                                                                                              #
#                                                                                                                                                                                                                                              #
#                                                                                                                                                                                                                                              #
#                                                                                                                                                                                                                                              #
#                                                    /////////////////////                                                                                             /////////////////////                                                   #
#                                                    /////////////////////                                                                                             /////////////////////                                                   #
#                                                   #/////////////////////#                                                                                           #/////////////////////#                                                  #
#                 ######################            #/////////////////////#                                                                                           #/////////////////////#              ######################             ##
##################~~~~~~~~~~~~~~~~~~~~~~##         ##/////////////////////##                                                                                         ##/////////////////////##           ##~~~~~~~~~~~~~~~~~~~~~~###############
###########~~~~~~~~~~~~~~~~~~~~~~~~~~~~~~##        ##/////////////////////##                                                                                         ##/////////////////////##         ##~~~~~~~~~~~~~~~~~~~~~~~~~~~~~~#########
##########~~~~~~~~~~~~~~~~~~~~~~~~~~~~~~~~##     ####/////////////////////####                                                                                     ####/////////////////////####     ##~~~~~~~~~~~~~~~~~~~~~~~~~~~~~~~~#########
######~~~~~~~~~~~~~~~~~~~~~~~~~~~~~~~~~~~~~##########################################################################################################################################################~~~~~~~~~~~~~~~~~~~~~~~~~~~~~~~~~~~~~~~~~~#
#~~~~~~~~~~~~~~~~~~~~~~~~~~~~~~~~~~~~~~~~~~~~~~~~~~~~~~~~~~~~~~~~~~~~~~~~~~~~~~~~~~~~~~~~~~~~~~~~~~~~~~~~~~~~~~~~~~~~~~~~~~~~~~~~~~~~~~~~~~~~~~~~~~~~~~~~~~~~~~~~~~~~~~~~~~~~~~~~~~~~~~~~~~~~~~~~~~~~~~~~~~~~~~~~~~~~~~~~~~~~~~~~~~~~~~~~~~~~~~#
#~~~~~~~~~~~~~~~~~~~~~~~~~~~~~~~~~~~~~~~~~~~~~~~~~~~~~~~~~~~~~~~~~~~~~~~~~~~~~~~~~~~~~~~~~~~~~~~~~~~~~~~~~~~~~~~~~~~~~~~~~~~~~~~~~~~~~~~~~~~~~~~~~~~~~~~~~~~~~~~~~~~~~~~~~~~~~~~~~~~~~~~~~~~~~~~~~~~~~~~~~~~~~~~~~~~~~~~~~~~~~~~~~~~~~~~~~~~~~~#
#~~~~~~~~~~~~~~~~~~~~~~~~~~~~~~~~~~~~~~~~~~~~~~~~~~~~~~~~~~~~~~~~~~~~~~~~~~~~~~~~~~~~~~~~~~~~~~~~~~~~~~~~~~~~~~~~~~~~~~~~~~~~~~~~~~~~~~~~~~~~~~~~~~~~~~~~~~~~~~~~~~~~~~~~~~~~~~~~~~~~~~~~~~~~~~~~~~~~~~~~~~~~~~~~~~~~~~~~~~~~~~~~~~~~~~~~~~~~~~#
#~~~~~~~~~~~~~~~~~~~~~~~~~~~~~~~~~~~~~~~~~~~~~~~~~~~~~~~~~~~~~~~~~~~~~~~~~~~~~~~~~~~~~~~~~~~~~~~~~~~~~~~~~~~~~~~~~~~~~~~~~~~~~~~~~~~~~~~~~~~~~~~~~~~~~~~~~~~~~~~~~~~~~~~~~~~~~~~~~~~~~~~~~~~~~~~~~~~~~~~~~~~~~~~~~~~~~~~~~~~~~~~~~~~~~~~~~~~~~~#
#~~~~~~~~~~~~~~~~~~~~~~~~~~~~~~~~~~~~~~~~~~~~~~~~~~~~~~~~~~~~~~~~~~~~~~~~~~~~~~~~~~~~~~~~~~~~~~~~~~~~~~~~~~~~~~~~~~~~~~~~~~~~~~~~~~~~~~~~~~~~~~~~~~~~~~~~~~~~~~~~~~~~~~~~~~~~~~~~~~~~~~~~~~~~~~~~~~~~~~~~~~~~~~~~~~~~~~~~~~~~~~~~~~~~~~~~~~~~~~#
#~~~~~~~~~~~~~~~~~~~~~~~~~~~~~~~~~~~~~~~~~~~~~~~~~~~~~~~~~~~~~~~~~~~~~~~~~~~~~~~~~~~~~~~~~~~~~~~~~~~~~~~~~~~~~~~~~~~~~~~~~~~~~~~~~~~~~~~~~~~~~~~~~~~~~~~~~~~~~~~~~~~~~~~~~~~~~~~~~~~~~~~~~~~~~~~~~~~~~~~~~~~~~~~~~~~~~~~~~~~~~~~~~~~~~~~~~~~~~~#
#~~~~~~~~~~~~~~~~~~~~~~~~~~~~~~~~~~~~~~~~~~~~~~~~~~~~~~~~~~~~~~~~~~~~~~~~~~~~~~~~~~~~~~~~~~~~~~~~~~~~~~~~~~~~~~~~~~~~~~~~~~~~~~~~~~~~~~~~~~~~~~~~~~~~~~~~~~~~~~~~~~~~~~~~~~~~~~~~~~~~~~~~~~~~~~~~~~~~~~~~~~~~~~~~~~~~~~~~~~~~~~~~~~~~~~~~~~~~~~#
#~~~~~~~~~~~~~~~~~~~~~~~~~~~~~~~~~~~~~~~~~~~~~~~~~~~~~~~~~~~~~~~~~~~~~~~~~~~~~~~~~~~~~~~~~~~~~~~~~~~~~~~~~~~~~~~~~~~~~~~~~~~~~~~~~~~~~~~~~~~~~~~~~~~~~~~~~~~~~~~~~~~~~~~~~~~~~~~~~~~~~~~~~~~~~~~~~~~~~~~~~~~~~~~~~~~~~~~~~~~~~~~~~~~~~~~~~~~~~~#
#~~~~~~~~~~~~~~~~~~~~~~~~~~~~~~~~~~~~~~~~~~~~~~~~~~~~~~~~~~~~~~~~~~~~~~~~~~~~~~~~~~~~~~~~~~~~~~~~~~~~~~~~~~~~~~~~~~~~~~~~~~~~~~~~~~~~~~~~~~~~~~~~~~~~~~~~~~~~~~~~~~~~~~~~~~~~~~~~~~~~~~~~~~~~~~~~~~~~~~~~~~~~~~~~~~~~~~~~~~~~~~~~~~~~~~~~~~~~~~#
#~~~~~~~~~~~~~~~~~~~~~~~~~~~~~~~~~~~~~~~~~~~~~~~~~~~~~~~~~~~~~~~~~~~~~~~~~~~~~~~~~~~~~~~~~~~~~~~~~~~~~~~~~~~~~~~~~~~~~~~~~~~~~~~~~~~~~~~~~~~~~~~~~~~~~~~~~~~~~~~~~~~~~~~~~~~~~~~~~~~~~~~~~~~~~~~~~~~~~~~~~~~~~~~~~~~~~~~~~~~~~~~~~~~~~~~~~~~~~~#
#~~~~~~~~~~~~~~~~~~~~~~~~~~~~~~~~~~~~~~~~~~~~~~~~~~~~~~~~~~~~~~~~~~~~~~~~~~~~~~~~~~~~~~~~~~~~~~~~~~~~~~~~~~~~~~~~~~~~~~~~~~~~~~~~~~~~~~~~~~~~~~~~~~~~~~~~~~~~~~~~~~~~~~~~~~~~~~~~~~~~~~~~~~~~~~~~~~~~~~~~~~~~~~~~~~~~~~~~~~~~~~~~~~~~~~~~~~~~~~#
#~~~~~~~~~~~~~~~~~~~~~~~~~~~~~~~~~~~~~~~~~~~~~~~~~~~~~~~~~~~~~~~~~~~~~~~~~~~~~~~~~~~~~~~~~~~~~~~~~~~~~~~~~~~~~~~~~~~~~~~~~~~~~~~~~~~~~~~~~~~~~~~~~~~~~~~~~~~~~~~~~~~~~~~~~~~~~~~~~~~~~~~~~~~~~~~~~~~~~~~~~~~~~~~~~~~~~~~~~~~~~~~~~~~~~~~~~~~~~~#
################################################################################################################################################################################################################################################
################################################################################################################################################################################################################################################